R    1500000 2000  
C  2, 25, 1000  

111111111111111
100000000000001
100200000000001
100000000000001
100020000000001
100000000000001
100000000000001
100000030000001
111111111111111